/===============================================================\
| razor doc (experimental) - rev 4.2.15                         |
|---------------------------------------------------------------|
|  Template: gen.vb.sqlserver (experimental version)            |
|   Website: http://www.pigford.net/razor                       |
|                                                               |
| Known Issues:                                                 |
\===============================================================/

Table: TblNavLink --> [NavLink]

  colNavControlId --> [NavControlId] int null
  colNavPracticeID --> [NavPracticeID] int null
  colNavLevelId --> [NavLevelId] int null
  colNavParentLinkId --> [NavParentLinkId] int null
  colNavLinkId --> [NavLinkId] int **PK** identity not null
  colNavText --> [NavText] varchar(50) not null
  colNavUrl --> [NavUrl] varchar(255) null
  colNavOrder --> [NavOrder] int not null
  colNavToolTip --> [NavToolTip] varchar(50) null
  colNavVisible --> [NavVisible] bit null
  colNavEnabled --> [NavEnabled] bit null
  colNavSpcFeature --> [NavSpcFeature] varchar(50) null
  colNavIsPracticeTopLink --> [NavIsPracticeTopLink] bit null
  colNavDefaultExpanded --> [NavDefaultExpanded] bit null
  colNavSiteMapKeyWord --> [NavSiteMapKeyWord] varchar(50) null
  colNavAllReportsKeyword --> [NavAllReportsKeyword] varchar(50) null
  colNavAllDataKeyword --> [NavAllDataKeyword] varchar(50) null
  colNavTarget --> [NavTarget] varchar(25) null
  colNavType --> [NavType] varchar(50) null
  colNavComment --> [NavComment] varchar(75) null
  colNavConstant --> [NavConstant] varchar(50) null
  colNavReportId --> [NavReportId] varchar(50) null
  colNavGridId --> [NavGridId] int null
  colNavChartId --> [NavChartId] int null
  colNavExtractId --> [NavExtractId] int null
  colNavBypassFilter --> [NavBypassFilter] bit not null
  colNavStatusToolTip --> [NavStatusToolTip] nvarchar(200) null
  colTimeStamp --> [TimeStamp] timestamp null
  colSlideMenuId --> [slideMenuId] int null
  colSlideGroupId --> [slideGroupId] int null
  colSlideLevelId --> [slideLevelId] int null
  colSlideType --> [slideType] varchar(25) null
  colSlideParentId --> [slideParentId] int null
  colSlideOrder --> [slideOrder] int null
  colSlideImageClassName --> [slideImageClassName] varchar(25) null
  colIsClientAdmin --> [IsClientAdmin] bit not null

